111111111111111111111111111111111
100000100000000000000000010000001
100000100000000000000000010000001
100000100000001000000000011111101
101111100000001000000000000000001
100000000000001000000000000000001
111111111111111101111010101111101
100000000000000000E00000000000001
100111111111111111111111111111111
10000000000000000C000000000000001
100111111111111111111111111111111
100000000000000000000000000000001
111111111111111111111111111111001
10000000000000000C000000000000001
100111111111111111111111111111111
100000000000000000000000000000001
111111111111111111111111111111001
100000000000000000000000000000001
100111111111111111111111111111111
100000000000000000000000000000001
10000000000P000000000000000000001
111111111111111111111111111111111