111111111111
100000000001
100011111101
10P000000101
100010000101
100000000101
100000000101
100000000101
100000000101
100000E00101
100000000101
100C00000101
100000000101
100000000101
111111111111